NO ./texture/dam.xpm
SO ./texture/hanok.xpm
WE ./texture/4gunja.xpm
EA ./texture/dam_photo.xpm

F 200,200,200
C 250,250,250

11111
10001
1NN01
10001
11111
