        1111111111111111111111111
        1000000000000000000000001
        1100000000000000000000001
        1000000000000000000000001
111111111000000000000000000000001
1000000000000000E0000000000001111
10000000000000000000000000001
10000000000000000000000000001
10000000000000000000000000001
10000000000000000000000000001
10000000000000000001010000001
11000001110101011111011110101
11110111 1110101 101111010001
11111111 1111111 111111111111
R 640 480
NO ./Texture/NO.xpm
SO ./Texture/SO.xpm
WE ./Texture/WE.xpm
EA ./Texture/EA.xpm

F 110,153,15
C 255,255,255
