111111111
10000PCE1
111111111
