12345678901234567
10000000000011111
11111100000001111
11111111111111111
11111111111111111
