1111111111111111111111
11000E00CP000000000001
1101110000000000000011
1100000000000000000001
1000000000000000000001
1000000000000000000001
1000000000000000000001
1000000000000000000001
1000000000000000000001
1000000000000000000011
1111111111111111111111
