11111111111111111
10000000000011111
11111100000000001
11111111111111111
11111111111111111
