11111111111111111
11000E00CP0011111
11011100000000001
11111111111111111
11111111111111111
