1111111111111
10000000000C1
1000000000001
1P00001E00001
1110001111111
111000CC11111
1111111111111
