1111111111111
10010000000C1
10N0011111001
1P0011E000001
1111110001111
111111CC11111
1111111111111
