111111111111111111111111111111
11000000CP00000000000000000001
110111000000000000000CCC000001
1110000000000000000001000000C1
100000000000000000000000000001
100000000000000000000111001111
100000000000000000000100001111
100000000000000000000100000011
100000000000000000000100000011
100000000000000000001100000111
111111111111111111111111111111
