111111111111111111111111111111
11000E00CP00000000000000000001
110111000000000000000CCC0000001
111000000000000000000100000EC01
1000000000000000000000000000001
1000000000000000000001110011101
1000000000000000000001000011101
1000000000000000000001000000101
1000000000000000000001000000101
100000000000000000001100000111
111111111111111111111111111111
