111111111111111111111111111111
11000E00CP00000000000000000001
110111000000000000000CCC000001
111000000000000000000100000EC1
100000000000000000000000000001
100000000000000000000111001111
100000000000000000000100001111
100000000000000000000100000011
100000000000000000000100000011
100000000000000000001100000111
111111111111111111111111111111
